20 20
2 2 2 2 2 2 2 0 2 2 2 2 2 2 0 0 0 0 0 0 
2 1 0 0 0 0 2 0 2 0 301 201 101 2 0 0 0 0 0 0 
2 0 100 0 200 0 2 0 2 0 0 0 0 2 0 0 0 0 0 0 
2 2 2 2 2 0 2 0 2 2 0 2 2 2 0 0 0 0 0 0 
0 0 0 0 2 0 2 0 0 2 0 2 0 0 0 0 0 0 0 0 
2 2 2 2 2 0 2 2 0 2 0 2 0 0 0 0 0 0 0 0 
2 0 0 0 0 0 0 2 0 2 0 2 0 0 0 0 0 0 0 0 
2 0 0 0 0 0 0 2 2 2 0 2 0 0 0 0 0 0 0 0 
2 0 0 0 300 2 2 2 0 0 0 2 2 0 0 0 0 0 0 0 
2 0 0 0 0 0 0 0 0 0 0 0 2 0 0 0 0 0 0 0 
2 2 2 2 2 2 2 2 0 0 0 0 2 0 0 0 0 0 0 0 
0 0 0 0 0 0 0 2 2 2 2 2 2 0 0 0 0 0 0 0 
0 0 0 0 0 0 0 0 0 0 0 0 0 0 0 0 0 0 0 0 
0 0 0 0 0 0 0 0 0 0 0 0 0 0 0 0 0 0 0 0 
0 0 0 0 0 0 0 0 0 0 0 0 0 0 0 0 0 0 0 0 
0 0 0 0 0 0 0 0 0 0 0 0 0 0 0 0 0 0 0 0 
0 0 0 0 0 0 0 0 0 0 0 0 0 0 0 0 0 0 0 0 
0 0 0 0 0 0 0 0 0 0 0 0 0 0 0 0 0 0 0 0 
0 0 0 0 0 0 0 0 0 0 0 0 0 0 0 0 0 0 0 0 
0 0 0 0 0 0 0 0 0 0 0 0 0 0 0 0 0 0 0 0 
