20 20
0 0 0 0 0 0 0 0 0 0 0 0 0 0 0 0 0 0 0 0 
0 0 0 0 0 0 0 0 0 0 0 0 0 0 0 0 0 0 0 0 
0 0 0 0 0 0 0 0 0 0 0 0 0 0 0 0 0 0 0 0 
0 0 0 0 0 2 2 2 0 2 2 2 0 0 0 0 0 0 0 0 
0 0 0 0 0 2 301 2 2 2 201 2 0 0 0 0 0 0 0 0 
0 0 0 0 0 2 0 301 0 0 0 2 2 2 0 0 0 0 0 0 
0 0 0 0 0 2 0 300 300 0 100 1 0 2 0 0 0 0 0 0 
0 0 0 2 2 2 0 0 0 0 0 2 2 2 0 0 0 0 0 0 
0 0 0 2 0 0 0 100 0 0 0 2 0 0 0 0 0 0 0 0 
0 0 0 2 2 2 2 0 200 0 0 2 0 0 0 0 0 0 0 0 
0 0 0 0 0 0 2 0 101 2 2 2 0 0 0 0 0 0 0 0 
0 0 0 0 0 0 2 0 101 2 0 0 0 0 0 0 0 0 0 0 
0 0 0 0 0 0 2 2 2 2 0 0 0 0 0 0 0 0 0 0 
0 0 0 0 0 0 0 0 0 0 0 0 0 0 0 0 0 0 0 0 
0 0 0 0 0 0 0 0 0 0 0 0 0 0 0 0 0 0 0 0 
0 0 0 0 0 0 0 0 0 0 0 0 0 0 0 0 0 0 0 0 
0 0 0 0 0 0 0 0 0 0 0 0 0 0 0 0 0 0 0 0 
0 0 0 0 0 0 0 0 0 0 0 0 0 0 0 0 0 0 0 0 
0 0 0 0 0 0 0 0 0 0 0 0 0 0 0 0 0 0 0 0 
0 0 0 0 0 0 0 0 0 0 0 0 0 0 0 0 0 0 0 0 
