20 20
2 2 2 2 2 2 2 2 2 2 2 2 2 2 2 2 2 2 2 2 
2 0 0 0 0 0 0 0 0 0 0 0 0 0 0 0 0 0 0 2 
2 100 300 201 200 201 200 201 200 201 200 201 200 201 200 201 200 301 0 2 
2 101 301 200 101 100 101 100 101 100 101 100 101 100 101 100 201 300 0 2 
2 100 300 201 100 301 300 301 300 301 300 301 300 301 300 101 200 301 0 2 
2 101 301 200 101 0 0 0 0 0 0 0 0 0 0 100 201 300 0 2 
2 100 300 201 100 0 0 0 0 0 0 0 0 0 0 101 200 301 0 2 
2 101 301 200 101 0 0 0 0 0 0 0 0 0 0 100 201 300 0 2 
2 100 300 201 100 0 0 0 0 0 0 0 0 0 0 101 200 301 0 2 
2 101 301 200 101 0 0 0 0 1 0 0 0 0 0 100 201 300 0 2 
2 100 300 201 100 0 0 0 0 0 0 0 0 0 0 101 200 301 0 2 
2 100 301 200 101 0 0 0 0 0 0 0 0 0 0 100 201 300 0 2 
2 101 300 201 100 0 0 0 0 0 0 0 0 0 0 101 200 301 0 2 
2 100 301 200 101 200 201 200 201 200 201 200 201 200 201 100 201 300 0 2 
2 101 300 201 300 301 300 301 300 301 300 301 300 301 300 301 200 301 0 2 
2 100 301 100 101 100 101 100 101 100 101 100 101 100 101 100 101 300 0 2 
2 101 200 201 200 201 200 201 200 201 200 201 200 201 200 201 200 201 0 2 
2 0 0 0 0 0 0 0 0 0 0 0 0 0 0 0 0 0 0 2 
2 0 0 0 0 0 0 0 0 0 0 0 0 0 0 0 0 0 0 2 
2 2 2 2 2 2 2 2 2 2 2 2 2 2 2 2 2 2 2 2 
